Hier volg 'n lys van Suid-Afrikaanse voëls alfabeties gelys volgens hulle Afrikaanse name. Die wetenskaplike naam van elke voël word ook aangedui.  Dieselfde voël kan meer as een maal in die lys voorkom indien dit meer as een Afrikaanse naam het.  Duplikaat Afrikaanse name van voëls kan nageslaan word deur die wetenskaplike naamlys van voëls te gebruik.  Waar nodig word 'n algemene voëlnaam wat 'n groepering van voëls verteenwoordig met die term  – Groepnaam aangedui.
A - B - C - D - E - F - G - H - I - J - K - L - M - N - O - P - Q - R - S - T - U - V - W - X - Y - Z - Sien ook


== A ==
Aasvoël – groepnaam
Adeliepikkewyn – Pygoscelis adeliae
Afrika-lepelaar – Platalea alba
Afrikaanse boomvalk – Falco cuvierii
Afrikaanse jagarend – Aquila spilogaster
Afrikaanse koekoek – Cuculus gularis
Afrikaanse kwartel – Coturnix coturnix
Afrikaanse naguil – Caprimulgus pectoralis
Afrikaanse oewerswael – Riparia paludicola
Afrikaanse paddavreter – Circus ranivorus
Afrikaanse riethaan – Crecopsis egregia
Afrikaanse snip – Gallinago nigripennis
Afrikaanse sperwer – Accipiter tachiro
Afrikaanse vleivalk – Circus ranivorus
Afrikaanse wielewaal – Oriolus auratus
Akasiagrysmees – Parus cinerascens
Akkedisvalk – Kaupifalco monogrammicus
Alaotra-dobbertjie – Tachybaptus rufolavatus
Albatros – groepnaam
Amerikaanse ekster – Pica hudsonia
Amerikaanse goue strandkiewiet – Pluvialis dominica
Amerikaanse griet – Fuselo emricano
Amerikaanse koningriethaan – Porphyrio martinicus
Amerikaanse peddie – Chionis albus
Andes-gans – Chloephaga melanoptera
Angolakalkoentjie – Macronyx fuellebornii
Angolakliplyster – Monticola angolensis
Angolapitta – Pitta angolensis
Angolaswael – Hirundo angolensis
Angolaswie – Coccopygia bocagei
Angolasysie – Estrilda thomensis
Antarktiese stormvoël – Thalassoica antarctica
Antarktiese walvisvoël – Pachyptila desolata
Arend – groepnaam
Arktiese roofmeeu – Stercorarius parasiticus
Arktiese seeswael – Sterna paradisaea
Arktiese sterretjie – Sterna paradisaea
Asiatiese patrys – Alectoris chukar
Asiatiese strandkiewiet – Charadrius asiaticus
Atlantiese geelneusalbatros – Thalassarche chlororhynchos
Atlantiese geelneusmalmok – Thalassarche chlororhynchos
Atlantiese stormvoël – Pterodroma incerta
Australiese malgas – Morus serrator


== B ==
Baardaasvoël – Gypaetus barbatus
Baardmannetjie – Sporopipes squamifrons
Baardspeg – Dendropicos namaquus
Baardwipstert – Cercotrichas quadrivirgata
Bairdse strandloper – Calidris bairdii
Baleariese pylstormvoël – Puffinus mauretanicus
Bandkeeljanfrederik – Swynnertonia swynnertoni
Bandkeelkleinjantjie – Apalis thoracica
Bandkeelkleinjantjie – Apalis thoracica
Bandkeelpikkewyn – Pygoscelis antarktika
Bandkeelvink – Amadina fasciata
Bandkopgans – Anser indicus
Bandstertgriet – Limosa lapponica
Bankduiker – Phalacrocorax neglectus
Baraustormvoël – Pterodroma baraui
Barlowse lewerik – Calendulauda barlowi
Basrarietsanger – Acrocephalus griseldis
Bartgeier – Gypaetus barbatus
Bassiaan – Procellaria aequinoctialis
Bassiaanstormvoël – Procellaria aequinoctialis
Beloogbosbontrokkie – Platysteira peltata
Bennettse speg – Campethera bennettii
Bergeend – Tadorna cana
Berghaan – Terathopius ecaudatus
Bergkanarie – Crithagra atrogularis
Bergklipwagter – Oenanthe bifasciata
Bergkoester – Anthus hoeschi
Bergkwikkie – Motacilla clara
Berglyster – Monticola rupestris
Bergpatrys – Scleroptila africanus
Bergpietjiekanarie – Crithagra symonsi
Bergwagter – Oenanthe monticola
Bewick-swaan – Cygnus bewickii
Bleekkopgrassanger – Acrocephalus griseldis
Bleekkopklopkloppie – Cisticola cinnamomeus
Bleeksingvalk – Melierax canorus
Bleekstrandkiewiet – Charadrius alexandrinus
Bleekvlerkkeilstert – Bulweria bulwerii
Bleekvlerkspreeu – Onychognathus nabouroup
Blesgans – Anser albifrons
Bleshoender – Fulica cristata
Bloubekalbatros – Thalassarche cauta
Bloubekeend – Oxyura maccoa
Bloubekmalmok – Thalassarche cauta
Blougrysvlieëvanger – Muscicapa caerulescens
Bloukatakoeroe – Coracina caesia
Bloukeelsuikerbekkie – Anthreptes reichenowi
Bloukopdrawwertjie – Cursorius rufus
Bloukorhaan – Eupodotis caerulescens
Bloukraanvoël – Anthropoides paradiseus
Bloukruissuikerbekkie – Cinnyris neergaardi
Bloukuifloerie – Musophaga porphyreolopha
Bloukuifvlieëvanger – Trochocercus cyanomelas
Bloukwartel – Coturnix adansonii
Bloupaddavreter – Circus pygargus
Bloupenspapegaai – Poicephalus rueppellii
Bloureier – Ardea cinerea
Bloustormvoël – Halobaena caerulea
Blousuikerbekkie – Anthreptes longuemarei
Blouswael – Hirundo atrocaerulea
Blouvalk – Elanus caeruleus
Blouvisvanger – Alcedo semitorquata
Blouvleivalk – Circus pygargus
Blouvlekduifie – Turtur afer
Blouwangbyvreter – Merops persicus
Blouwangooievaar – Ciconia nigra
Bokmakierie – Telophorus zeylonus
Bontelsie – Recurvirostra avosetta
Bontfraiingpoot – Phalaropus tricolor
Bonthoutkapper – Tricholaema leucomelas
Bontkiewiet – Vanellus armatus
Bontkopkanarie – Serinus leucolaemus
Bontkwartel – Coturnix delegorguei
Bontkwikkie – Motacilla aguimp
Bontnuwejaarsvoël – Clamator jacobinus
Bontpiek – Myrmecocichla arnotti
Bontrokkie – groepnaam
Bontroklaksman – Nilaus afer
Bontrugwewer – Ploceus cucullatus
Bontskaapwagter – Oenanthe pleschanka
Bontstrandloper – Calidris alpina
Bonttobie – Haematopus ostralegus
Bontvisvanger – Ceryle rudis
Bontwindswael – Tachymarptis aequatorialis
Boomkoester – Anthus trivialis
Boomkruiper – Salpornis spilonotus
Boomkruiper – Salpornis spilonotus
Bosbontrokkie – groepnaam
Bosjakkalsvoël – Buteo trizonatus
Boskoester – Anthus nyassae
Boskorhaan – Eupodotis ruficrista
Boskraai – groepnaam
Boskrapper – Phyllastrephus terrestris
Boskruiper – groepnaam
Bosloerie – Apaloderma narina
Bosluisvoël – groepnaam
Bosmusikant – Ploceus bicolor
Bospatrys – Dendroperdix sephaena
Bosruiter – Tringa glareola
Bosuil – Strix woodfordii
Bosveldfisant – Francolinus swainsonii
Bosveldkoester – Anthus caffer
Bosveldkwarteltjie – Turnix sylvatica
Bosveldlewerik – Mirafra passerina
Bosveldpapegaai – Poicephalus meyeri
Bosveldstompstert – Sylvietta rufescens
Bosveldtinktinkie – Cisticola chiniana
Bosveldtjeriktik – Parisoma subcaeruleum
Bosveldvisvanger – Halcyon senegalensis
Bradfieldse neushoringvoël – Tockus bradfieldi
Brandervoël – groepnaam
Breëbek – Smithornis capensis
Breëbekstrandloper – Limicola falcinellus
Breëbekwalvisvoël – Pachyptila vittata
Breëkoparend – Polemaetus bellicosus
Breëstertgrasvoël – Melocichla mentalis
Breëstertparadysvink – Vidua obtusa
Breëstertsanger – Schoenicola brevirostris
Brilbassiaan – Procellaria conspicillata
Brilmalgas – Sula dactylatra
Brilpikkewyn – Spheniscus demersus
Brilseeswael – Onychoprion anaethetus
Brilsterretjie – Onychoprion anaethetus
Brilwewer – Ploceus ocularis
Bromvoël – Bucorvus leadbeateri
Bronssuikerbekkie – Nectarinia kilimensis
Bronsvlerkdrawwertjie – Rhinoptilus chalcopterus
Bruinalbatros – Phoebetria fusca
Bruinarend – Aquila wahlbergi
Bruineend – Netta erythrophthalma
Bruinjakkalsvoël – Buteo vulpinus
Bruinkeelbossanger – Eremomela usticollis
Bruinkeelwewer – Ploceus xanthopterus
Bruinkoppapegaai – Poicephalus cryptoxanthus
Bruinkopvisvanger – Halcyon albiventris
Bruinmalgas – Sula leucogaster
Bruinmalmok – Phoebetria fusca
Bruinpylstormvoël – Puffinus carneipes
Bruinrobbin – Lagonosticta nitidula
Bruinroofmeeu – Catharacta antarctica
Bruinslangarend – Circaetus cinereus
Bruinsylangstertjie – Prinia subflava
Bruinvlekstormvoël – Pterodroma incerta
Bruinvuurvinkie – Lagonosticta nitidula
Bruinwewer – Ploceus rubiginosus
Bruinwindswael – Apus pallidus
Bruinwipstert – Cercotrichas signata
Buffelwewer – Bubalornis niger
Bulwerse stormvoël – Bulweria bulwerii
Byvanger – groepnaam
Byvreter – groepnaam


== C ==
Cereopsis-gans – Cereopsis novaehollandiae
Chathamalbatros – Thalassarche eremita
Chathammalmok – Thalassarche eremita
Coscoroba-swaan – Coscoroba coscoroba


== D ==
Damarakorhaan – Eupodotis rueppellii
Damararooibekneushoringvoël – Tockus damarensis
Damaraseeswael – Sterna balaenarum
Damarasterretjie – Sterna balaenarum
Dassievoël – Thamnolaea cinnamomeiventris
Dickinsonse grysvalk – Falco dickinsoni
Diederikkie – Chrysococcyx caprius
Dikbekfret – Spermestes fringilloides
Dikbekkanarie – Crithagra sulphuratus
Dikbekkoekoek – Pachycoccyx audeberti
Dikbeklewerik – Galerida magnirostris
Dikbekstreepkoppie – Nesospiza wilkinsi
Dikbekwewer – Amblyospiza albifrons
Dikkop – groepnaam
Dobbertjie – groepnaam
Donkergrysvalk – Falco ardosiaceus
Donkerkoester – Anthus leucophrys
Donkerlewerik – Pinarocorys nigricans
Donkernaguil – Caprimulgus tristigma
Donkersingvalk – Melierax metabates
Donkervlerkkeilstert – Bulweria fallax
Donkervlieëvanger – Muscicapa adusta
Donkerwangbossanger – Eremomela scotops
Donsveerstormvoël – Pterodroma mollis
Draadstertswael – Hirundo smithii
Draaihals – Jynx ruficollis
Drakensberglangstertjie – Prinia hypoxantha
Drakensberglewerik – Heteromirafra ruddi
Drawwertjie – groepnaam
Driebanddrawwertjie – Rhinoptilus cinctus
Driebandstrandkiewiet – Charadrius tricollaris
Driestreeptjagra – Tchagra australis
Drietoonstrandloper – Calidris alba
Dubbelbanddrawwertjie – Rhinoptilus africanus
Dubbelbandsandpatrys – Pterocles bicinctus
Dubbelbandslangarend – Circaetus fasciolatus
Dubbelsnip – Gallinago media
Duif – groepnaam
Duiker – groepnaam
Duinlewerik – Calendulauda erythrochlamys
Dunbekheuningvoël – Prodotiscus zambesiae
Dunbekmeeu – Larus genei
Dunbekwalvisvoël – Pachyptila belcheri
Dwergarend – Hieraaetus pennatus
Dwerggans – Nettapus auritus
Dwerglangtoon – Microparra capensis
Dwergrietreier – Ixobrychus sturmii
Dwergvalk – Polihierax semitorquatus
Dwergvisvanger – Ispidina picta


== E ==
Eaton se pylsterteend – Anas eatoni
Edelvalk – Falco biarmicus
Eend – groepnaam
Egiptiese aasvoël – Neophron percnopterus
Elegante sterretjie – Thalasseus elegans
Eleonoravalk – Falco eleonorae
Elsie – groepnaam
Enkelbandslangarend – Circaetus cinerascens
Europese bontrokkie – Saxicola rubetra
Europese boomvalk – Falco subbuteo
Europese byvreter – Merops apiaster
Europese koekoek – Cuculus canorus
Europese naguil – Caprimulgus europaeus
Europese oewerswael – Riparia riparia
Europese paddavreter – Circus aeruginosus
Europese rietsanger – Acrocephalus palustris
Europese rooistert – Phoenicurus phoenicurus
Europese skaapwagter – Oenanthe oenanthe
Europese slopeend – Anas clypeata
Europese sperwer – Accipiter nisus
Europese spreeu – Sturnus vulgaris
Europese stormswael – Hydrobates pelagicus
Europese swael – Hirundo rustica
Europese swartkroonsanger – Sylvia atricapilla
Europese tortelduif – Streptopelia turtur
Europese troupant – Coracias garrulus
Europese vleisanger – Acrocephalus schoenobaenus
Europese vleivalk – Circus aeruginosus
Europese vlieëvanger – Muscicapa striata
Europese wielewaal – Oriolus oriolus
Europese windswael – Apus apus


== F ==
Familieswael – Hirundo spilodera
Familievoël – Philetairus socius
Feevlieëvanger – Stenostira scita
Fisant – groepnaam
Fiskaallaksman – Lanius collaris
Fiskaalvlieëvanger – Sigelus silens
Flamink – groepnaam
Flap – groepnaam
Fluiteend – Dendrocygna bicolor
Fluitswaan – Cygnus columbianus
Fraiingpoot – groepnaam
Franklinse meeu – Larus pipixcan
Fregatvoël – groepnaam
Fret – groepnaam
Fulmarwalvisvoël – Pachyptila crassirostis


== G ==
Gans – groepnaam
Gariepglasogie – Zosterops pallidus
Gebande oewerswael – Riparia cincta
Gebande sanger – Calamonastes fasciolatus
Gebande sperwer – Accipiter badius
Gebande uil – Glaucidium capense
Geelbekbosduif – Columba arquatrix
Geelbekeend – Anas undulata
Geelbeklyster – Turdus smithi
Geelbekneushoringvoël – Tockus leucomelas
Geelbekpylstormvoël – Calonectris diomedea
Geelbekrenostervoël – Buphagus africanus
Geelbekseeswael – Sterna bergii
Geelbeksterretjie – Sterna bergii
Geelbektroupant – Eurystomus glaucurus
Geelbekwitreier – Ardea intermedia
Geelbekwou – Milvus aegyptius parasitus
Geelbleshoutkapper – Stactolaema whytii
Geelblestinker – Pogoniulus chrysoconus
Geelborshyliota – Hyliota flavigaster
Geelborskanarie – Serinus citrinipectus
Geelborskleinjantjie – Apalis flavida
Geelborskoester – Anthus chloris
Geelborsstrandkiewiet – Charadrius pecuarius
Geelborstiptol – Chlorocichla flaviventris
Geelborswillie – Chlorocichla flaviventris
Geelglasogie – Zosterops senegalensis
Geelkanarie – Crithagra flaviventris
Geelkeelkalkoentjie – Macronyx croceus
Geelkeelsandpatrys – Pterocles gutturalis
Geelkeelsanger – Phylloscopus ruficapilla
Geelkuifpikkewyn – Eudyptes chrysocome
Geelkwikkie – Motacilla flava
Geelneusalbatros – Thalassarche chlororhynchos
Geelneusmalmok – Thalassarche chlororhynchos
Geeloogkanarie – Serinus mozambicus
Geelpensbossanger – Eremomela icteropygialis
Geelpenssuikerbekkie – Cinnyris venustus
Geelpootstormswael – Oceanites oceanicus
Geelpootstrandloper – Calidris melanotos
Geelrugflap – Euplectes macroura
Geelrugmelba – Pytilia afra
Geelrugsysie – Pytilia afra
Geelsanger – Chloropeta natalensis
Geelstreepboskruiper – Phyllastrephus flavostriatus
Geelstreepkoppie – Emberiza cabanisi
Geelstreeptiptol – Phyllastrephus flavostriatus
Geelvlekmossie – Petronia superciliaris
Geelvleknikator – Nicator gularis
Geelwewer – Ploceus subaureus
Gekroonde neushoringvoël – Tockus alboterminatus
Gestreepte kanarie – Crithagra scotops
Gestreepte koester – Anthus lineiventris
Gestreepte kransswael – Phedina borbonica
Gestreepte nuwejaarsvoël – Clamator levaillantii
Gestreepte pylstormvoël – Calonectris leucomelas
Gestreepte riethaan – Aenigmatolimnas marginalis
Gestreepte visvanger – Halcyon chelicuti
Gestreepte vleikuiken – Sarothrura affinis
Gestreepte vleiloerie – Centropus superciliosus
Gestreepte wipstert – Cercotrichas leucophrys
Gevlekte arend – Aquila pomarina
Gevlekte eend – Anas hottentota
Gevlekte heuningwyser – Indicator variegatus
Gevlekte klopkloppie – Cisticola textrix
Gevlekte koekoek – Clamator glandarius
Gevlekte langstertjie – Saffron prinia
Gevlekte lyster – Psophocichla litsitsirupa
Gevlekte muisvoël – Colius striatus
Gevlekte ooruil – Bubo africanus
Gevlekte riethaan – Porzana porzana
Gevlekte rooipootruiter – Tringa erythropus
Gevlekte sandpatrys – Pterocles burchelli
Gevlekte speg – Campethera cailliautii
Gevlekte stekelstert – Telacanthura ussheri
Gevlekte vleikuiken – Sarothrura elegans
Gewone blousysie – Uraeginthus angolensis
Gewone blouvinkie – Vidua funerea
Gewone bontrokkie – Saxicola torquatus
Gewone boskraai – Ceratogymna bucinator
Gewone dikkop – Burhinus capensis
Gewone duikstormvoël – Pelacanoides urinatrix
Gewone fret – Spermestes cucullatus
Gewone janfrederik – Cossypha caffra
Gewone kakelaar – Phoeniculus purpureus
Gewone kiewiet – Vanellus coronatus
Gewone koester – Anthus cinnamomeus
Gewone kwartelvinkie – Ortygospiza atricollis
Gewone kwikkie – Motacilla capensis
Gewone melba – Pytilia melba
Gewone mossie – Passer melanurus
Gewone nagreier – Nycticorax nycticorax
Gewone paradysvink – Vidua paradisaea
Gewone ruiter – Actitis hypoleucos
Gewone seeswael – Sterna hirundo
Gewone spekvreter – Cercomela familiaris
Gewone sterretjie – Sterna hirundo
Gewone stormswael – Oceanites oceanicus
Gewone swartmees – Parus niger
Gewone tarentaal – Numida meleagris
Gewone tortelduif – Streptopelia capicola
Gewone troupant – Coracias caudata
Gewone vleiloerie – Centropus burchellii
Gewone willie – Andropadus importunus
Glansibis – Plegadis falcinellus
Glasogie – groepnaam
Gompou – Ardeotis kori
Goudgeelvink – Euplectes afer
Goudkoester – Tmetothylacus tenellus
Goudsnip – Rostratula benghalensis
Goudstertspeg – Campethera abingoni
Goudwewer – Ploceus xanthops
Goughwaterhoender – Gallinula comeri
Goughstreepkoppie – Rowettia goughensis
Grasuil – Tyto capensis
Grasveldlangbeklewerik – Certhilauda semitorquata
Grasvoël – Sphenoeacus afer
Griet – groepnaam
Groenblouvinkie – Vidua codringtoni
Groenbossanger – Eremomela gregalis
Groenglasogie – Zosterops virens
Groenhoutkapper – Stactolaema olivacea
Groenkolpensie – Mandingoa nitidula
Groenkopeend – Anas platyrhynchos
Groenkopwielewaal – Oriolus chlorocephalus
Groenpootruiter – Tringa nebularia
Groenrobbin – Mandingoa nitidula
Groenrugkwêkwêvoël – Camaroptera brachyura
Groenrugreier – Butorides striata
Groentinker – Pogoniulus simplex
Groenvleiloerie – Ceuthmochares aereus
Groenvlekduif – Turtur chalcospilos
Grondspeg – Geocolaptes olivaceus
Grootalbatros – Diomedea exulans
Grootalbatros – Diomedea exulans
Grootblouoorglansspreeu – Lamprotornis chalybaeus
Grootbruinseeswael – Anous stolidus
Grootbruinsterretjie – Anous stolidus
Grootflamink – Phoenicopterus roseus
Grootfregatvoël – Fregata minor
Grootgeelpootruiter – Tringa melanoleuca
Grootglansspreeu – Lamprotornis australis
Grootheuningwyser – Indicator indicator
Grootjagarend – Aquila spilogaster
Grootknoet – Calidris tenuirostris
Grootkoningriethaan – Porphyrio madagascariensis
Grootlangtoon – Actophilornis africanus
Grootmalmok – Diomedea exulans
Grootmalmok – Diomedea exulans
Grootmossie – Passer motitensis
Grootnellie – Macronectes halli
Grootpapegaai – Poicephalus robustus
Grootpeddie – Chionis albus
Grootpylstormvoël – Puffinus gravis
Grootriethaan – Rallus caerulescens
Grootrietreier – Botaurus stellaris
Grootrietsanger – Acrocephalus arundinaceus
Grootringduif – Streptopelia semitorquata
Grootrooibandsuikerbekkie – Cinnyris afer
Groot-rooioogtortelduif – Streptopelia semitorquata
Grootrooivalk – Falco rupicoloides
Grootseeswael – Sterna sandvicensis
Grootskedebek – Chionis albus
Grootsterretjie – Sterna sandvicensis
Grootstrandkiewiet – Charadrius leschenaultii
Grootstreepswael – Cecropis cucullata
Grootswartooievaar – Ciconia nigra
Grootswartvlerkkiewiet – Vanellus melanopterus
Groottinktinkie – Cisticola natalensis
Groottroupant – Coracias naevius
Grootvleiloerie – Centropus cupreicaudus
Grootvlieëvanger – Bradornis infuscatus
Grootwaterhoender – Gallinula chloropus
Grootwitreier – Ardea alba
Grootwulp – Numenius arquata
Grys gebande sanger – Calamonastes simplex
Grysborsseeswael – Sterna vittata
Grysborssterretjie – Sterna vittata
Grysborstjagra – Tchagra tchagra
Grysfraiingpoot – Phalaropus fulicaria
Gryskapokvoël – Anthoscopus caroli
Gryskleinjantjie – Apalis chirindensis
Gryskopalbatros – Thalassarche chrysostoma
Gryskopmalmok – Thalassarche chrysostoma
Gryskopmeeu – Chroicocephalus cirrocephalus
Gryskopmossie – Passer diffusus
Gryskoppie – Fringilla coelebs
Gryskopspeg – Dendropicos griseocephalus
Gryskopvisvanger – Halcyon leucocephala
Gryskruisswael – Pseudhirundo griseopyga
Gryskwikkie – Motacilla cinerea
Gryslaksman – Lanius minor
Grysneushoringvoël – Tockus nasutus
Gryspylstormvoël – Procellaria cinerea
Grysrugkwêkwêvoël – Camaroptera brevicaudata
Grysruglewerik – Eremopterix verticalis
Grysrugstormswael – Garrodia nereis
Grysrugtinktinkie – Cisticola subruficapillus
Grysstrandkiewiet – Pluvialis squatarola
Grysstrandkiewiet – Pluvialis squatarola
Gryssuikerbekkie – Cyanomitra veroxii
Gryssysie – Estrilda perreini
Grystjeriktik – Parisoma layardi
Grysvlekpylstormvoël – Puffinus griseus
Gunningse janfrederik – Sheppardia gunningi


== H ==
Hadeda – Bostrychia hagedash
Halsbandparkiet – Psittacula krameri
Hamerkop – Scopus umbretta
Haringmeeu – Larus argentatus
Hartlaubse meeu – Chroicocephalus hartlaubii
Hererospekvreter – Namibornis herero
Hermanse rietsanger – Acrocephalus scirpaceus
Heuglinse janfrederik – Cossypha heuglini
Heuglinse meeu – Larus heuglini
Heuningvoël – groepnaam
Heuningwyser – groepnaam
Hoephoep – Upupa africana
Hoëveldklappertjie – Mirafra fasciolata
Hoëveldskaapwagter – Oenanthe pileata
Hofsanger – Phylloscopus ruficapillus
Horuswindswael – Apus horus
Houtkapper – groepnaam
Hudsonbaaigriet – Limosa haemastica
Huiltinktinkie – Cisticola lais
Huiskraai – Corvus splendens
Huismossie – Passer domesticus
Huisswael – Delichon urbica
Hyliota – groepnaam


== I ==
Ibis – groepnaam
Inaccessible-eilandriethaan – Atlantisia rogersi
Indiese geelneusalbatros – Thalassarche carteri
Indiese geelneusmalmok – Thalassarche carteri
Indiese spreeu – Acridotheres tristis
Isabellaskaapwagter – Oenanthe isabellina


== J ==
Jakkalsvoël – groepnaam
Jamesonse robbin – Lagonosticta rhodopareia
Jamesonse vuurvinkie – Lagonosticta rhodopareia
Janfrederik – groepnaam
Jangroentjie – Nectarinia famosa
Jouaninse stormvoël – Bulweria fallax


== K ==
Kaalwangkatlagter – Turdoides gymnogenys
Kaalwangvalk – Polyboroides typus
Kaapse berglyster – Chaetops frenatus
Kaapse bosbontrokkie – Batis capensis
Kaapse fisant – Francolinus capensis
Kaapse flap – Euplectes capensis
Kaapse glasogie – Zosterops virens
Kaapse kanarie – Serinus canicollis
Kaapse kapokvoël – Anthoscopus minutus
Kaapse klappertjie – Mirafra apiata
Kaapse kliplyster – Monticola rupestris
Kaapse kwarteltjie – Turnix hottentottus
Kaapse ooruil – Bubo capensis
Kaapse pietjiekanarie – Crithagra totta
Kaapse rietsanger – Acrocephalus gracilirostris
Kaapse robbin – Lagonosticta rubricata
Kaapse slopeend – Anas smithii
Kaapse suikervoël – Promerops cafer
Kaapse tiptol – Pycnonotus capensis
Kaapse vleisanger – Bradypterus baboecala
Kaapse vuurvinkie – Lagonosticta rubricata
Kaapse wewer – Ploceus capensis
Kakelaar – groepnaam
Kalaharipatrys – Scleroptila levaillantoides
Kalahariwipstert – Cercotrichas paena
Kalkoenibis – Geronticus calvus
Kalkoentjie – groepnaam
Kanarie – groepnaam
Kaneelborssanger – Euryptila subcinnamomea
Kaneelduif – Columba larvata
Kaneelrietsanger – Acrocephalus cinnamomeus
Kaokolangbeklewerik – Certhilauda benguelensis
Kapokvoël – groepnaam
Kardinaalkwelea – Quelea cardinalis
Kardinaalspeg – Dendropicos fuscescens
Karoolangbeklewerik – Certhilauda subcoronata
Karoolangstertjie – Prinia maculosa
Karoolewerik – Calendulauda albescens
Karoospekvreter – Cercomela schlegelii
Katakoeroe – groepnaam
Katlagter – groepnaam
Keilstert – groepnaam
Keilstertpylstormvoël – Puffinus pacificus
Keiserduiker – Phalacrocorax atriceps
Keiserpikkewyn – Aptenodytes forsteri
Kelkiewyn – Pterocles namaqua
Kelpmeeu – Larus dominicanus
Kemphaan – Philomachus pugnax
Kentse strandkiewiet – Charadrius alexandrinus
Kerguelense stormvoël – Lugensa brevirostris
Kerguelenseeswael – Sterna virgata
Kerguelensterretjie – Sterna virgata
Kiewiet – groepnaam
Kimberleykoester – Anthus pseudosimilis
Klappertjie – groepnaam
Kleinblouoorglansspreeu – Lamprotornis chloropterus
Kleinbloureier – Egretta caerulea
Kleinboskruiper – Phyllastrephus debilis
Kleinbostiptol – Phyllastrephus debilis
Kleinbruinseeswael – Anous tenuirostris
Kleinbruinsterretjie – Anous tenuirostris
Kleinbyvanger – Dicrurus ludwigii
Kleinbyvreter – Merops pusillus
Kleindobbertjie – Tachybaptus ruficollis
Kleinduikstormvoël – Pelacanoides georgicus
Kleinflamink – Phoenicopterus minor
Kleinfregatvoël – Fregata ariel
Kleingeelpootruiter – Tringa flavipes
Kleingeelvink – Ploceus intermedius
Kleinglansspreeu – Lamprotornis nitens
Kleinheuningwyser – Indicator minor
Kleinjagarend – Aquila ayresii
Kleinjantjie – groepnaam
Kleinkoekoek – Cuculus poliocephalus
Kleinkoningriethaan – Porphyrio alleni
Kleinpeddie – Chionis minor
Kleinpelikaan – Pelecanus rufescens
Kleinpylstormvoël – Puffinus assimilis
Kleinriethaan – Porzana pusilla
Kleinrietreier – Ixobrychus minutus
Kleinrietsanger – Acrocephalus baeticatus
Kleinringnekstrandkiewiet – Charadrius dubius
Kleinrooibandsuikerbekkie – Cinnyris chalybeus
Kleinrooivalk – Falco naumanni
Kleinseeswael – Sterna albifrons
Kleinsingvalk – Melierax gabar
Kleinsperwer – Accipiter minullus
Kleinste klopkloppie – Cisticola ayresii
Kleinsterretjie – Sterna albifrons
Kleinstrandloper – Calidris minuta
Kleinstreepswael – Cecropis abyssinica
Kleinswartooievaar – Ciconia abdimii
Kleinswartrugmeeu – Larus fuscus
Kleinswartvlerkkiewiet – Vanellus lugubris
Kleinwaterhoender – Gallinula angulata
Kleinwindswael – Apus affinis
Kleinwitreier – Egretta garzetta
Kleinwulp – Numenius phaeopus
Klipfisant – Francolinus hartlaubi
Klipkoester – Anthus crenatus
Kliplyster – Monticola rupestris
Klipstreepkoppie – Emberiza tahapisi
Klopkloppie – groepnaam
Knobbeleend – Sarkidiornis melanotos
Knoet – Calidris canutus
Knopstertroofmeeu – Stercorarius pomarinus
Knopsterttroupant – Coracias spatulata
Knysnaloerie – Tauraco corythaix
Knysnaruigtesanger – Bradypterus sylvaticus
Knysnaspeg – Campethera notata
Koekoek – groepnaam
Koekoekvalk – Aviceda cuculoides
Koekoekvink – Anomalospiza imberbis
Koester – groepnaam
Kolgans – Alopochen aegyptiacus
Kolpensie – groepnaam
Koningalbatros – Diomedea epomophora
Koningblousysie – Uraeginthus granatinus
Koningmalmok – Diomedea epomophora
Koningpikkewyn – Aptenodytes patagonicus
Koningrooibekkie – Vidua macroura
Koningseeswael – Sterna maxima
Koningsterretjie – Sterna maxima
Koningweduweetjie – Vidua macroura
Koningweduweetjie – Vidua macroura
Konkoit – Telophorus viridis
Kopereend – Tadorna cana
Kopersuikerbekkie – Cinnyris cupreus
Korhaan – groepnaam
Koringvoël – Plocepasser mahali
Kortbeksuikerbekkie – Anthreptes collaris
Kortkloulewerik – Certhilauda chuana
Kortstertflap – Euplectes axillaris
Kortstertkoester – Anthus brachyurus
Kortstertlaksman – Lanioturdus torquatus
Korttoonkliplyster – Monticola brevipes
Kortvlerktinktinkie – Cisticola brachypterus
Kraai – groepnaam
Kraanvoël – groepnaam
Kransaasvoël – Gyps coprotheres
Kransduif – Columba guinea
Kransswael – Hirundo fuligula
Kransvalk – Falco rupicolus
Krapvreter – Dromas ardeola
Kremetartlaksman – Eurocephalus anguitimens
Krombekstrandloper – Calidris ferruginea
Kroonarend – Stephanoaetus coronatus
Kroonkiewiet – Vanellus coronatus
Kruiper – groepnaam
Kuifeend – Aythya fuligula
Kuifkopboskraai – Ceratogymna brevis
Kuifkopdobbertjie – Podiceps cristatus
Kuifkopduiker – Phalacrocorax coronatus
Kuifkophoutkapper – Trachyphonus vaillantii
Kuifkopseeswael – Thalasseus bengalensis
Kuifkopsterretjie – Sterna bengalensis
Kuifkoptarentaal – Guttera edouardi
Kuifkopvisvanger – Alcedo cristata
Kwartel – groepnaam
Kwartelkoning – Crex crex
Kwarteltjie – groepnaam
Kwêkwêvoël – groepnaam
Kwelea – groepnaam
Kwêvoël – Corythaixoides concolor
Kwikkie – groepnaam


== L ==
Laeveldklappertjie – Mirafra rufocinnamomea
Laeveldnaguil – Caprimulgus fossii
Laeveldpatrys – Scleroptila shelleyi
Laksman – groepnaam
Lammergier – Gypaetus barbatus
Landeryklopkloppie – Cisticola juncidis
Langbeenjakkalsvoël – Buteo rufinus
Langbeenkorhaan – Eupodotis melanogaster
Langbeklewerik – Certhilauda curvirostris
Langkuifarend – Lophaetus occipitalis
Langkuifloerie – Tauraco schalowi
Langkuifpikkewyn – Eudyptes chrysolophus
Langstertflap – Euplectes progne
Langstertglansspreeu – Lamprotornis mevesii
Langstertjie – groepnaam
Langstertkoekoek – Cercococcyx montanus
Langstertkoester – Anthus longicaudatus
Langstertlaksman – Corvinella melanoleuca
Langstertroofmeeu – Stercorarius longicaudus
Langtoon – groepnaam
Langtoonkliplyster – Monticola explorator
Langtoonstrandloper – Calidris subminuta
Langvlerkstormvoël – Pterodroma macroptera
Lawaaimakerjanfrederik – Cossypha dichroa
Laysan-albatros – Phoebastria immutabilis
Laysan-malmok – Phoebastria immutabilis
Lelkiewiet – Vanellus senegallus
Lelkraanvoël – Bugeranus carunculatus
Lelspreeu – Creatophora cinerea
Lemoenduif – Streptopelia senegalensis
Lewerik – groepnaam
Loerie – groepnaam
Luapulatinktinkie – Cisticola luapula
Ludwigse pou – Neotis ludwigii
Luitinktinkie – Cisticola aberrans
Lyster – groepnaam
Lysternagtegaal – Luscinia luscinia


== M ==
Macaronipikkewyn – Eudyptes chrysolophus
Madagaskarkoekoek – Cuculus rochii
Madagaskar-ralreier – Ardeola idae
Madeirastormswael – Oceanodroma castro
Magellaanpikkewyn – Spheniscus magellanicus
Mahem – Balearica regulorum
Makou – groepnaam
Makpou – Pavo cristatus
Malbaartjie – Puffinus griseus
Malgas – groepnaam
Malgassiese ralreier – Ardeola idae
Malmok – groepnaam
Manglietvisvanger – Halcyon senegaloides
Maraboe – Leptoptilos crumeniferus
Maricosuikerbekkie – Cinnyris mariquensis
Maricovlieëvanger – Bradornis mariquensis
Marionwalvisvoël – Pachyptila salvini
Mashonahyliota – Hyliota australis
Matsudairase stormswael – Oceanodroma matsudairae
Meerswael – groepnaam
Mees – groepnaam
Meeu – groepnaam
Meitjie – Chrysococcyx klaas
Melba – groepnaam
Melbasysie – Pytilia melba
Mikstertbyvanger – Dicrurus adsimilis
Mikstertmeeu – Larus sabini
Miombogrysmees – Parus griseiventris
Miombo-rooibandsuikerbekkie – Cinnyris manoensis
Moerasruiter – Tringa stagnatilis
Moeraswaterfiskaal – Laniarius bicolor
Mongoolse strandkiewiet – Charadrius mongolus
Monnikaasvoël – Necrosyrtes monachus
Monteirose neushoringvoël – Tockus monteiri
Mooimeisie – Chrysococcyx cupreus
Mosambiekbosbontrokkie – Batis soror
Mosambiekloerie – Tauraco livingstonii
Moskeeswael – Cecropis senegalensis
Mossie – groepnaam
Muiskleurvlieëvanger – Bradornis pallidus
Muiskleurwindswael – Apus bradfieldi
Muisvoël – groepnaam


== N ==
Nagtegaal – groepnaam
Nagtegaallyster – Luscinia luscinia
Naguil – groepnaam
Namakwaduif – Oena capensis
Namakwalangstertjie – Phragmacia substriata
Namakwalewerik – Spizocorys sclateri
Namakwaspeg – Dendropicos namaquus
Namakwasuikerbekkie – Cinnyris fuscus
Namiblewerik – Ammomanopsis grayi
Nataljanfrederik – Cossypha natalensis
Natallyster – Zoothera guttata
Natalse fisant – Francolinus natalensis
Natalse naguil – Caprimulgus natalensis
Neddikie – Cisticola fulvicapilla
Nellie – groepnaam
Neushoringvoël – groepnaam
Nicholsonse koester – Anthus similis
Nightingale-streepkoppie – Nesospiza questi
Nikator – groepnaam
Nimmersat – Mycteria ibis
Njassaparkiet – Agapornis lilianae
Nonnetjie-eend – Dendrocygna viduata
Nonnetjie-uil – Tyto alba
Nuwejaarsvoël – groepnaam


== O ==
Olyfboomsanger – Hippolais olivetorum
Olyfboslaksman – Telophorus olivaceus
Olyfbyvreter – Merops superciliosus
Olyfkopwewer – Ploceus olivaceiceps
Olyflyster – Turdus olivaceus
Olyfsuikerbekkie – Cyanomitra olivacea
Ooievaar – groepnaam
Oopbekooievaar – Anastomus lamelligerus
Oostelike heuningwyser – Indicator meliphilus
Oostelike rooipootvalk – Falco amurensis
Oostelike saadbrekertjie – Pyrenestes minor
Oostelike seeswael – Gelochelidon nilotica
Oostelike sterretjie – Sterna nilotica
Oosterse goue strandkiewiet – Pluvialis fulva
Oosterse stormswael – Oceanodroma matsudairae
Oranjeborsberglyster – Chaetops aurantius
Oranjeborsboslaksman – Telophorus sulfureopectus
Oranjeborssuikerbekkie – Anthobaphes violacea
Oranjekeelkalkoentjie – Macronyx capensis
Oranjelyster – Zoothera gurneyi
Oranjevlerkmelba – Pytilia afra
Oranjevlerksysie – Pytilia afra
Ovambosperwer – Accipiter ovampensis
Ovamboswartmees – Parus carpi
Overberglangbeklewerik – Certhilauda brevirostris


== P ==
Paddavreter – groepnaam
Palmmôrelyster – Cichladusa arquata
Palmwindswael – Cypsiurus parvus
Palmwindswael – Cypsiurus parvus
Papegaai – groepnaam
Papegaaiduif – Treron calva
Paradyskraanvoël – Grus paradisea
Paradysvlieëvanger – Terpsiphone viridis
Parkiet – groepnaam
Patrys – groepnaam
Peddie – groepnaam
Pediunker – Procellaria cinerea
Pelikaan – groepnaam
Pêrelborsswael – Hirundo dimidiata
Persblouvinkie – Vidua wilsoni
Perskakelaar – Phoeniculus damarensis
Piek – groepnaam
Pienkbeklewerik – Spizocorys conirostris
Piepende tinktinkie – Cisticola pipiens
Piet-my-vrou – Cuculus solitarius
Piet-tjou-tjougrysmees – Parus afer
Pikkewyn – groepnaam
Pitta – groepnaam
Pou – groepnaam
Priritbosbontrokkie – Batis pririt
Purperbandsuikerbekkie – Cinnyris bifasciatus
Pylstert – groepnaam
Pylsterteend – Anas acuta
Pylstertrooibekkie – Vidua regia
Pylstertweduweetjie – Vidua regia
Pylstertweduweetjie – Vidua regia
Pylstormvoël – Puffinus yelkouan
Pylvlekkatlagter – Turdoides jardineii


== R ==
Ralreier – Ardeola ralloides
Reier – groepnaam
Renostervoël – groepnaam
Reusenellie – Macronectes giganteus
Reuse-ooruil – Bubo lacteus
Reusereier – Ardea goliath
Reuseseeswael – Hydroprogne caspia
Reusesterretjie – Hydroprogne caspia
Reusevisvanger – Megaceryle maxima
Rietduiker – Phalacrocorax africanus
Riethaan – groepnaam
Ringnekpapegaai – Psittacula krameri
Ringnekparkiet – Psittacula krameri
Ringnekstrandkiewiet – Charadrius hiaticula
Robbin – groepnaam
Roek – Corvus frugilegus
Roerdomp – Botaurus stellaris
Roeskopbyvreter – Merops boehmi
Roetseeswael – Sterna fuscata
Roetsterretjie – Sterna fuscata
Roetvalk – Falco concolor
Roofarend – Aquila rapax
Roofmeeu – groepnaam
Rooiassie – Amandava subflava
Rooibandstrandkiewiet – Charadrius pallidus
Rooibekeend – Anas erythrorhyncha
Rooibekfisant – Francolinus adspersus
Rooibekkakelaar – Phoeniculus purpureus
Rooibekkie – Estrilda astrild
Rooibekkwelea – Quelea quelea
Rooibeklyster – Turdus libonyanus
Rooibekneushoringvoël – Tockus erythrorhynchus
Rooibekpylstert – Phaethon aethereus
Rooibekrenostervoël – Buphagus erythrorhynchus
Rooibekrobbin – Lagonosticta senegala
Rooibeksysie – Estrilda astrild
Rooibektiptol – Lioptilus nigricapillus
Rooibekvuurvinkie – Lagonosticta senegala
Rooiblestinker – Pogoniulus pusillus
Rooiborsbyvreter – Merops nubicoides
Rooiborsduif – Streptopelia senegalensis
Rooiborsgans – Branta ruficollis
Rooiborsjakkalsvoël – Buteo rufofuscus
Rooiborslaksman – Laniarius atrococcineus
Rooiborsruigtesanger – Bradypterus victorini
Rooiborsseeswael – Sterna dougallii
Rooiborssperwer – Accipiter rufiventris
Rooiborssterretjie – Sterna dougallii
Rooiborssuikerbekkie – Chalcomitra senegalensis
Rooiborssuikervoël – Promerops gurneyi
Rooiborsswael – Cecropis semirufa
Rooiborsvleikuiken – Sarothrura rufa
Rooibruinrietsanger – Acrocephalus rufescens
Rooihalsfraiingpoot – Phalaropus lobatus
Rooikeelbyvreter – Merops bullockoides
Rooikeelfisant – Francolinus afer
Rooikeelflap – Euplectes ardens
Rooikeelkoester – Anthus cervinus
Rooikeelkolpensie – Hypargos niveoguttatus
Rooikeelreier – Egretta vinaceigula
Rooikeelrobbin – Hypargos niveoguttatus
Rooikeelsuikerbekkie – Nectarinia senegalensis
Rooikopgans – Chloephaga rubidiceps
Rooikophoutkapper – Lybius torquatus
Rooikopkwelea – Quelea erythrops
Rooikoplewerik – Calandrella cinerea
Rooikopvink – Amadina erythrocephala
Rooikopwewer – Anaplectes melanotis
Rooikroonstompstert – Sylvietta ruficapilla
Rooikuifloerie – Musophaga rossae
Rooilewerik – Calendulauda burra
Rooineklewerik – Mirafra africana
Rooinekstrandloper – Calidris ruficollis
Rooinekswael – Cecropis daurica
Rooinekvalk – Falco chicquera
Rooioogtiptol – Pycnonotus nigricans
Rooioogtortelduif – Streptopelia decipiens
Rooioorlangstertjie – Malcorus pectoralis
Rooipensmees – Parus rufiventris
Rooipensreier – Ardeola rufiventris
Rooipootelsie – Himantopus himantopus
Rooipootmalgas – Sula sula
Rooipootruiter – Tringa totanus
Rooipylstert – Phaethon rubricauda
Rooireier – Ardea purpurea
Rooirugfret – Spermestes bicolor
Rooiruglaksman – Lanius collurio
Rooiruglewerik – Eremopterix leucotis
Rooirugrobbin – Cryptospiza reichenovii
Rooirugsaadvretertjie – Cryptospiza reichenovii
Rooirugstreepkoppie – Emberiza flaviventris
Rooistert – groepnaam
Rooistertmôrelyster – Cichladusa ruficauda
Rooistertrobbin – Pyrenestes minor
Rooistertsaadvretertjie – Pyrenestes minor
Rooistertvlieëvanger – Erythrocercus livingstonei
Rooitinktinkie – Cisticola rufilatus
Rooivalk – Falco rupicolus
Rooivink – Euplectes orix
Rooivlerkkwartelvinkie – Paludipasser locustella
Rooivlerkpatrys – Scleroptila levaillantii
Rooivlerksanger – Heliolais erythropterus
Rooivlerkspreeu – Onychognathus morio
Rooivlerksprinkaanvoël – Glareola pratincola
Rooivlerkstreepkoppie – Emberiza capensis
Rooivlerktjagra – Tchagra australis
Rooivlerktjagra – Tchagra australis
Rooiwangmuisvoël – Urocolius indicus
Rooiwangnaguil – Caprimulgus rufigena
Rooiwangparkiet – Agapornis roseicollis
Rooiwangstompstert – Sylvietta whytii
Rooiwangtinktinkie – Cisticola erythrops
Rooiwangwoudsysie – Cryptospiza reichenovii
Rooskeelkalkoentjie – Macronyx ameliae
Rooskeelkolpensie – Hypargos margaritatus
Rooskeelrobbin – Hypargos margaritatus
Roosspreeu – Pastor roseus
Rotsvoël – Achaetops pycnopygius
Ruddse kleinjantjie – Apalis ruddi
Ruigtesanger – Bradypterus barratti
Ruiter – groepnaam
Rüppellaasvoël – Gyps rueppellii


== S ==
Saadvretertjie – groepnaam
Saalbekooievaar – Ephippiorhynchus senegalensis
Sabotalewerik – Calendulauda sabota
Salvinalbatros – Thalassarche salvini
Salvinamalmok – Thalassarche salvini
Salvinse walvisvoël – Pachyptila salvini
Sandpatrys – groepnaam
Sanger – groepnaam
Savannepapegaai – Poicephalus fuscicollis
Seeduifstormvoël – Daption capense
Seeswael – groepnaam
Sekretarisvoël – Sagittarius serpentarius
Senegalvleiloerie – Centropus senegalensis
Silwerstormvoël – Fulmarus glacialoides
Singende tinktinkie – Cisticola cantans
Singswaan – Cygnus cygnus
Sitrienkwikkie – Motacilla citreola
Skaapwagter – groepnaam
Skaarswindswael – Schoutedenapus myoptilus
Skerpbekheuningvoël – Prodotiscus regulus
Skoorsteenveër – Threskiornis aethiopicus
Skopsuil – Otus senegalensis
Slanghalsvoël – Anhinga rufa
Slangverklikker – Cercotrichas coryphoeus
Sneeubal – Dryoscopus cubla
Sneeuwitreier – Egretta thula
Snip – groepnaam
Somereend – Anas querquedula
Souzase laksman – Lanius souzae
Speg – groepnaam
Spekvreter – groepnaam
Sperwer – groepnaam
Spitsstertglansspreeu – Lamprotornis acuticaudus
Spookvoël – Malaconotus blanchoti
Spoorvlerkkiewiet – Vanellus spinosus
Spotlewerik – Mirafra cheniana
Spotsanger – Hippolais icterina
Spotvoël – Hippolais icterina
Spreeu – groepnaam
Sprinkaansanger – Locustella fluviatilis
Sprinkaanvoël – groepnaam
Staalblouvinkie – Vidua chalybeata
Steenloper – Arenaria interpres
Stekelkophelmlaksman – Prionops scopifrons
Stekelstert – groepnaam
Steppe-arend – Aquila nipalensis
Sterretjie – groepnaam
Stierlingse sanger – Calamonastes stierlingi
Stompstert – groepnaam
Stormswael – groepnaam
Stormvoël – groepnaam
Strandkiewiet – groepnaam
Strandloper – groepnaam
Streepborsvleikuiken – Sarothrura boehmi
Streepkopkanarie – Crithagra gularis
Streepkoppie – groepnaam
Streepwangtiptol – Andropadus milanjensis
Streepwangwillie – Andropadus milanjensis
Suidelike swie – Coccopygia melanotis
Suidelike waterfiskaal – Laniarius ferrugineus
Suidelikesysie – Coccopygia melanotis
Suidpoolroofmeeu – Catharacta maccormicki
Suikerbekkie – groepnaam
Suikervoël – groepnaam
Swaan – groepnaam
Swael – groepnaam
Swaelstertbyvreter – Merops hirundineus
Swaelstertstormswael – Oceanodroma leucorhoa
Swartaasvoël – Torgos tracheliotos
Swartbandlangstertjie – Prinia flavicans
Swartbekkakelaar – Rhinopomastus cyanomelas
Swartbekpylstormvoël – Puffinus puffinus
Swartberglyster – Pinarornis plumosus
Swartblestinker – Pogoniulus bilineatus
Swartborsslangarend – Circaetus pectoralis
Swarteend – Anas sparsa
Swarthelmlaksman – Prionops retzii
Swartkatakoeroe – Campephaga flava
Swartkeelgeelvink – Ploceus velatusSwartkoekoek – Cuculus clamosus
Swartkopalbatros – Phoebetria palpebrata
Swartkopkanarie – Alario alario
Swartkopkleinjantjie – Apalis melanocephala
Swartkopmalmok – Phoebetria palpebrata
Swartkopmees – Parus rufiventris
Swartkopmeeu – Larus ridibundus
Swartkopreier – Ardea melanocephala
Swartkopseeswael – Anous minutus
Swartkopsterretjie – Anous minutus
Swartkoptjagra – Antichromus anchietae
Swartkopwielewaal – Oriolus larvatus
Swartkorhaan – Eupodotis afra
Swartkraai – Corvus capensis
Swartkroonpylstormvoël – Puffinus lherminieri
Swartkroonsanger – Sylvia atricapilla
Swartkroonseeswael – Sterna sumatrana
Swartkroonsterretjie – Sterna sumatrana
Swartkroontjagra – Tchagra senegala
Swartmeerswael – Chlidonias niger
Swartnekdobbertjie – Podiceps nigricollis
Swartnekseeswael – Sterna sumatrana
Swartneksterretjie – Sterna sumatrana
Swartnekswaan – Cygnus melancoryphus
Swartoogboslaksman – Telophorus nigrifrons
Swartoogsysie – Estrilda thomensis
Swartoogtiptol – Pycnonotus barbatus
Swartoorkanarie – Crithagra mennelli
Swartoorlewerik – Eremopterix australis
Swartpensglansspreeu – Lamprotornis corruscus
Swartpensstormswael – Fregetta tropica
Swartpenssuikerbekkie – Cinnyris shelleyi
Swartpiek – Myrmecocichla formicivora
Swartpootbrandervoël – Rissa tridactyla
Swartpootstormswael – Hydrobates pelagicus
Swartreier – Egretta ardesiaca
Swartriethaan – Amaurornis flavirostra
Swartrugalbatros – Thalassarche melanophrys
Swartrugkwarteltjie – Turnix nanus
Swartrugmalmok – Thalassarche melanophrys
Swartrugmeeu – Larus dominicanus
Swartrugtinktinkie – Cisticola galactotes
Swartsaagvlerkswael – Psalidoprocne holomelaena
Swartskouernaguil – Caprimulgus nigriscapularis
Swartsperwer – Accipiter melanoleucus
Swartsterretjie – Chlidonias niger
Swartstertgriet – Limosa limosa
Swartstertwalvisvoël – Pachyptila turtur
Swartsuikerbekkie – Chalcomitra amethystina
Swarttobie – Haematopus moquini
Swartvleiloerie – Centropus grillii
Swartvlerkkoningalbatros – Diomedea sanfordi
Swartvlerkkoningmalmok – Diomedea sanfordi
Swartvlerkkorhaan – Afrotis afra
Swartvlerksprinkaanvoël – Glareola nordmanni
Swartvlieëvanger – Melaenornis pammelaina
Swartwangalbatros – Phoebastria immutabilis
Swartwangkatlagter – Turdoides melanops
Swartwangmalmok – Phoebastria immutabilis
Swartwangparkiet – Agapornis nigrigenis
Swartwangsysie – Estrilda erythronotos
Swartwindswael – Apus barbatus
Swartwou – Milvus migrans
Swempie – Francolinus coqui
Swerfvalk – Falco peregrinus
Swie – groepnaam
Swinhoestormswael – Oceanodroma monorhis
Sysie – groepnaam


== T ==
Taanborsstrandloper – Tryngites subruficollis
Taitavalk – Falco fasciinucha
Tanzaniese speg – Campethera scriptoricauda
Tarentaal – groepnaam
Teeleend – Anas capensis
Temminckse strandloper – Calidris temminckii
Terekruiter – Xenus cinereus
Tinker – groepnaam
Tinktinkie – groepnaam
Tiptol – groepnaam
Tjagra – groepnaam
Tjeriktik – groepnaam
Tobie – groepnaam
Toringvalk – Falco tinnunculus
Trekdrawwertjie – Cursorius temminckii
Trekduiker – Phalacrocorax capensis
Tristangrootalbatros – Diomedea dabbenena
Tristangrootmalmok – Diomedea dabbenena
Tristanlyster – Nesocichla eremita
Tristanstreepkoppie – Nesospiza acunhae
Tropiese kleinpylstormvoël – Puffinus bailloni
Tropiese saagvlerkswael – Psalidoprocne pristoptera
Tropiese swie – Coccopygia quartinia
Tropiese waterfiskaal – Laniarius aethiopicus
Tropiesesysie – Coccopygia quartinia
Troupant – groepnaam
Tuinduif – Columba livia
Tuinsanger – Sylvia borin


== U ==
Uil – groepnaam


== V ==
Vaalbruinlewerik – Calendulauda africanoides
Vaalkoester – Anthus vaalensis
Vaalkorhaan – Eupodotis vigorsii
Vaalrivierlewerik – Spizocorys fringillaris
Vaalskaapwagter – Oenanthe isabellina
Vaalstrandkiewiet – Charadrius marginatus
Vaalstreepkoppie – Emberiza impetuani
Valk – groepnaam
Veereier – Bubulcus ibis
Veldpou – Neotis denhami
Versamelvoël – Philetairus socius
Vink – groepnaam
Vinkie – groepnaam
Visarend – Haliaeetus vocifer
Visuil – Scotopelia peli
Visvalk – Pandion haliaetus
Visvanger – groepnaam
Vlaktespekvreter – Cercomela sinuata
Vlaktelewerik – Chersomanes albofasciata
Vleikuiken – groepnaam
Vleiloerie – groepnaam
Vleitinktinkie – Cisticola tinniens
Vleitjagra – Antichromus anchietae
Vlei-uil – Asio capensis
Vleivalk – groepnaam
Vlermuisvalk – Macheiramphus alcinus
Vlieëvanger – groepnaam
Volstruis – Struthio camelus
Vuurkopvink – Euplectes hordeaceus
Vuurvinkie – groepnaam


== W ==
Waaierstertvlieëvanger – Myioparus plumbeus
Wagter – groepnaam
Wahlbergse arend – Aquila wahlbergi
Walvisvoël – groepnaam
Waterdikkop – Burhinus vermiculatus
Waterfiskaal – groepnaam
Waterhoender – groepnaam
Waterploeër – Rynchops flavirostris
Watertrapper – Podica senegalensis
Weduweetjie – groepnaam
Weskuslangbeklewerik – Certhilauda curvirostris
Wespedief – Pernis apivorus
Westelike kusreier – Egretta gularis
Westelike rooipootvalk – Falco vespertinus
Wewer – groepnaam
Wielewaal – groepnaam
Wildemakou – Plectropterus gambensis
Wildeposduif – Columba livia
Willie – groepnaam
Wimpelvlerknaguil – Macrodipteryx vexillarius
Windswael – groepnaam
Wipstert – groepnaam
Witaasvoël – Gypohierax angolensis
Witbaardmeerswael – Chlidonias hybrida
Witbaardsterretjie – Chlidonias hybridus
Witborsduifie – Turtur tympanistria
Witborsduiker – Phalacrocorax carbo
Witborsjakkalsvoël – Buteo augur
Witborskatakoeroe – Coracina pectoralis
Witborskraai – Corvus albus
Witborslyster – Alethe fuelleborni
Witborspaddavreter – Circus macrourus
Witborsspreeu – Cinnyricinclus leucogaster
Witborsvleivalk – Circus macrourus
Witborswoudlyster – Pseudalethe fuelleborni
Witbrouvleiloerie –  Centropus superciliosus
Witgatruiter – Tringa ochropus
Witgatspreeu – Spreo bicolor
Witgesigstormswael – Pelagodroma marina
Withalsbosduif – Columba delegorguei
Withalskraai – Corvus albicollis
Withalssprinkaanvoël – Glareola nuchalis
Withalsvlieëvanger – Ficedula albicollis
Withelmlaksman – Prionops plumatus
Witkatlagter – Turdoides bicolor
Witkeelalariovink – Alario leucolaema
Witkeelbyvreter – Merops albicollis
Witkeeljanfrederik – Cossypha humeralis
Witkeelkanarie – Serinus albogularis
Witkeelmossie – Passer griseus
Witkeelsanger – Sylvia communis
Witkeelswael – Hirundo albigularis
Witkenpylstormvoël – Procellaria aequinoctialis
Witkoljanfrederik – Pogonocichla stellata
Witkoluil – Glaucidium perlatum
Witkopaasvoël – Aegypius occipitalis
Witkopkiewiet – Vanellus albiceps
Witkopsaagvlerkswael – Psalidoprocne albiceps
Witkopstormvoël – Pterodroma lessonii
Witkroonalbatros – Thalassarche bulleri
Witkroonmalmok – Thalassarche bulleri
Witkruisarend – Aquila verreauxii
Witkruiskatlagter – Turdoides hartlaubii
Witkruismuisvoël – Colius colius
Witkruispaddavreter – Circus maurus
Witkruissperwer – Melierax gabar
Witkruisvleivalk – Circus maurus
Witkruiswindswael – Apus caffer
Witliesbosbontrokkie – Batis molitor
Witmalgas – Morus capensis
Witooievaar – Ciconia ciconia
Witoorhoutkapper – Stactolaema leucotis
Witoorpikkewyn – Pygoscelis papua
Witpelikaan – Pelecanus onocrotalus
Witpenskorhaan – Eupodotis senegalensis
Witpensstekelstert – Neafrapus boehmi
Witpensstormswael – Fregetta grallaria
Witpenssuikerbekkie – Cinnyris talatala
Witpensvlieëvanger – Bias musicus
Witpensvlieëvanger – Bias musicus
Witpenswindswael – Tachymarptis melba
Witpootblouvinkie – Vidua purpurascens
Witpylstert – Phaethon lepturus
Witrugaasvoël – Gyps africanus
Witrugeend – Thalassornis leuconotus
Witrugnagreier – Gorsachius leuconotus
Witrugstrandloper – Calidris fuscicollis
Witstertvlieëvanger – Elminia albonotata
Witstormvoël – Pagodroma nivea
Witvlerkflap – Euplectes albonotatus
Witvlerkkanarie – Serinus leucopterus
Witvlerkkiewiet – Vanellus crassirostris
Witvlerkkoningalbatros – Diomedea epomophora
Witvlerkkoningmalmok – Diomedea epomophora
Witvlerkkorhaan – Afrotis afraoides
Witvlerkmeerswael – Chlidonias leucopterus
Witvlerkmeerswael – Chlidonias leucopterus
Witvlerksterretjie – Chlidonias leucopterus
Witvlerkvleikuiken – Sarothrura ayresi
Witwangseeswael – Sterna repressa
Witwangsterretjie – Sterna repressa
Witwangstormswael – Pelagodroma marina
Witwanguil – Otus leucotis
Woestynklopkloppie – Cisticola aridulus
Woestynkorhaan – Eupodotis rueppellii
Woestynlewerik – Eremalauda starki
Woestynspekvreter – Cercomela tractrac
Wolnekooievaar – Ciconia episcopus
Woodwardse bosbontrokkie – Batis fratrum
Wou – groepnaam
Woudapie – Ixobrychus minutus
Woudlangstertjie – Oreophilais robertsi
Woudpapegaai – Poicephalus robustus
Wulp – groepnaam


== Sien ook ==
Lys van Suider-Afrikaanse voëls volgens wetenskaplike name
Lys van Suid-Afrikaanse voëls (Groepeer)
Newman se Voëls van Suider-Afrika
Sasol Voëls van Suider-Afrika